3 3 3 3 3 3 3 3 3 3 3 3
3 3 3 3 1 1 1 1 2 2 2 3
3 3 3 3 1 1 1 1 2 5 2 3
3 0 0 0 1 1 1 1 2 0 2 3
4 4 4 4 4 4 4 4 4 4 4 4
3 0 0 0 0 0 0 0 0 0 0 3
3 0 0 0 0 0 0 0 0 0 0 3
3 3 3 3 3 3 3 3 3 3 3 3
